Materials

Nama Material	    Resep Material
Refined Plate	    5x Heavy Ore
Arcane Crystal	    5x Mana Shard
Silent Thread	    5x Fine Fiber

====================================
====================================

Knight Materials

    Iron Scrap (Universal/Shop)
    Heavy Ore (Material Dasar Knight - Drop Dungeon)
    Refined Plate (Material Olahan - Dibuat di Alchemist dari 5x Heavy Ore)
    Void Essence (Material Rare - Drop Dungeon Void)

NNama Weapon	            Resep Material
Iron Claymore	            10x Iron Scrap + 5x Heavy Ore
Knight’s Heavy Axe	        15x Heavy Ore + 5x Iron Scrap
Ashen Smasher	            30x Heavy Ore + 2x Refined Plate
Deep-Earth Maul	            10x Refined Plate + 15x Heavy Ore
Executioner’s Pride	        20x Refined Plate + 30x Heavy Ore
Void-Iron Cleaver	        35x Refined Plate + 50x Heavy Ore
Calamity Breaker	        40x Void Essence + 20x Refined Plate

Nama Helmet	                Resep Material
Iron Pot Helm	            6x Iron Scrap + 3x Heavy Ore
Guard’s Visor	            15x Heavy Ore + 5x Iron Scrap
Ember-Steel Mask	        25x Heavy Ore + 2x Refined Plate
Grave-Guardian Helm     	8x Refined Plate + 15x Heavy Ore
Gladiator’s Crown	        15x Refined Plate + 25x Heavy Ore
Abyssal Greathelm	        25x Refined Plate + 40x Heavy Ore
Marshall’s Iron Face	    25x Void Essence + 15x Refined Plate

Nama Armor	                Resep Material
Reinforced Leather	        10x Iron Scrap + 8x Heavy Ore
Half-Plate Mail	            25x Heavy Ore + 2x Refined Plate
Volcanic Cuirass	        40x Heavy Ore + 5x Refined Plate
Ancient Oak Armor	        15x Refined Plate + 30x Heavy Ore
Dragonscale Hauberk	        25x Refined Plate + 45x Heavy Ore
Void-Reaper Plate	        40x Refined Plate + 60x Heavy Ore
God-King’s Bastion	        50x Void Essence + 25x Refined Plate

Nama Boots	                Resep Material
Hardened Soles	            5x Iron Scrap + 3x Heavy Ore
Plated Sabatons	            15x Heavy Ore + 5x Iron Scrap
Magma-Walkers	            25x Heavy Ore + 2x Refined Plate
Ever-Root Greaves	        8x Refined Plate + 15x Heavy Ore
Titan’s Footsteps	        12x Refined Plate + 20x Heavy Ore
Shadow-Step Sabatons	    20x Refined Plate + 30x Heavy Ore
Grand Marshall’s Stride	    20x Void Essence + 12x Refined Plate

====================================
====================================

Sorcerer Materials

    Iron Scrap (Universal/Shop)
    Mana Shard (Material Dasar Sorcerer - Drop Dungeon)
    Arcane Crystal (Material Olahan - Dibuat di Alchemist dari 5x Mana Shard)
    Void Essence (Material Rare - Drop Dungeon Depth tinggi)

Nama Weapon	                Resep Material
Birch Staff	                10x Iron Scrap + 5x Mana Shard
Scholar's Grimoire	        15x Mana Shard + 5x Iron Scrap
Ignis Core Staff	        30x Mana Shard + 2x Arcane Crystal
Tome of Eternity	        10x Arcane Crystal + 15x Mana Shard
Celestial Spire	            20x Arcane Crystal + 30x Mana Shard
Abyssal Eye	                35x Arcane Crystal + 50x Mana Shard
Genesis Pillar	            40x Void Essence + 20x Arcane Crystal

Nama Helmet	                Resep Material
Silk Circlet	            6x Iron Scrap + 3x Mana Shard
Sage’s Veil	                15x Mana Shard + 5x Iron Scrap
Cinder Hood	                25x Mana Shard + 2x Arcane Crystal
Tiara of Insight	        8x Arcane Crystal + 15x Mana Shard
Diadem of Stars         	15x Arcane Crystal + 25x Mana Shard
Crown of the Void	        25x Arcane Crystal + 40x Mana Shard
Astral Halo	                25x Void Essence + 15x Arcane Crystal

Nama Armor	                Resep Material
Scholar’s Tunic	            10x Iron Scrap + 8x Mana Shard
Mystic Vestment	            25x Mana Shard + 2x Arcane Crystal
Pyromancer’s Mantle     	40x Mana Shard + 5x Arcane Crystal
Elder Root Robe	            15x Arcane Crystal + 30x Mana Shard
Nebula Gown	                25x Arcane Crystal + 45x Mana Shard
Voidshaper Shroud	        40x Arcane Crystal + 60x Mana Shard
Eternity Raiment	        50x Void Essence + 25x Arcane Crystal

Nama Boots	                Resep Material
Linen Shoes	                5x Iron Scrap + 3x Mana Shard
Enchanter’s Boots	        15x Mana Shard + 5x Iron Scrap
Flame-Walk Shoes	        25x Mana Shard + 2x Arcane Crystal
Ley-Line Greaves	        8x Arcane Crystal + 15x Mana Shard
Phase Boots	                12x Arcane Crystal + 20x Mana Shard
Abyssal Walkers	            20x Arcane Crystal + 30x Mana Shard
God-Stepper Soles	        20x Void Essence + 12x Arcane Crystal

====================================
====================================

Wanderer Materials

    Iron Scrap (Universal/Shop)
    Fine Fiber (Material Dasar Wanderer - Drop Dungeon)
    Silent Thread (Material Olahan - Dibuat di Alchemist dari 5x Fine Fiber)
    Void Essence (Material Rare - Drop Dungeon Depth tinggi)

Nama Weapon	                Resep Material
Hunter's Crossbow	        10x Iron Scrap + 5x Fine Fiber
Heavy Arbalest	            15x Fine Fiber + 5x Iron Scrap
Flamestrike Bow	            30x Fine Fiber + 2x Silent Thread
Verdant Crossbow	        10x Silent Thread + 15x Fine Fiber
Eagle-Eye Piercer	        20x Silent Thread + 30x Fine Fiber
Void-Stinger	            35x Silent Thread + 50x Fine Fiber
Final Nightfall	            40x Void Essence + 20x Silent Thread

Nama Helmet	                Resep Material
Leather Cap             	6x Iron Scrap + 3x Fine Fiber
Reinforced Coif	            15x Fine Fiber + 5x Iron Scrap
Cinder Hood	                25x Fine Fiber + 2x Silent Thread
Silent Nightcap         	8x Silent Thread + 15x Fine Fiber
Assassin’s Visage	        15x Silent Thread + 25x Fine Fiber
Specter’s Gaze	            25x Silent Thread + 40x Fine Fiber
Shroud of Nightfall	        25x Void Essence + 15x Silent Thread

Nama Armor	                Resep Material
Leather Jerkin	            10x Iron Scrap + 8x Fine Fiber
Ranger’s Garb	            25x Fine Fiber + 2x Silent Thread
Salamander Hide	            40x Fine Fiber + 5x Silent Thread
Nature’s Embrace	        15x Silent Thread + 30x Fine Fiber
Mistwalker Tunic	        25x Silent Thread + 45x Fine Fiber
Abyssal Stealth-Suit	    40x Silent Thread + 60x Fine Fiber
Eternal Night-Skin	        50x Void Essence + 25x Silent Thread

Nama Boots	                Resep Material
Leather Boots	            5x Iron Scrap + 3x Fine Fiber
Scout Greaves	            15x Fine Fiber + 5x Iron Scrap
Magma-Step Boots	        25x Fine Fiber + 2x Silent Thread
Wind-Runner Boots	        8x Silent Thread + 15x Fine Fiber
Shadow-Step Treads	        12x Silent Thread + 20x Fine Fiber
Ghost-Walkers	            20x Silent Thread + 30x Fine Fiber
Nightfall’s Path	        20x Void Essence + 12x Silent Thread

====================================
====================================

Nama Item	                Resep Material
Iron Ring	                20x Heavy Ore + 10x Iron Scrap
Glass Monocle	            20x Mana Shard + 10x Iron Scrap
Feather Charm	            20x Fine Fiber + 10x Iron Scrap
Vitality Band	            15x Heavy Ore + 15x Mana Shard + 15x Fine Fiber
Mana Crystal	            40x Mana Shard + 10x Arcane Crystal
Warrior’s Emblem	        10x Refined Plate + 10x Arcane Crystal + 10x Silent Thread
Steel Gauntlet	            25x Refined Plate + 30x Heavy Ore
Medallion of Life	        25x Arcane Crystal + 30x Mana Shard
Silver Rosary	            25x Silent Thread + 30x Fine Fiber
Void Pendulum	            30x Void Essence + 5x Refined Plate + 5x Arcane Crystal + 5x Silent Thread
